          
##########
#T      S#
#        #
#        #
#        #
#        #
#        #               
#        #
#        #
#        #
#        #
#        #
#        #
#        #
#        #
#        #
#        #
#        #
#       B#
##########
