                                                
                / /|\|\ /|\ | 
                \|-|/|/|-| ||-
                / \|\|  \| | \_🐍

#################################################
#T///////////////////////////////////////////// #
# ///////////////////////////////////////////// #
# ///////////////////////////////////////////// #
# //////////////WWWWWWWWWWWWWWWWW////////////// #
# //////////////W       W       W////////////// #
# //////////////W   2       1   W////////////// #
# //////////////WS              W////////////// #
# //////////////WWWWW       WWWWW////////////// #
# //////////////W               WWWWWWWWWWWWWWWW#
# //////////////W   3   W   4       5       E   #
# //////////////W       W       WWWWWWWWWWWWWWWW#
# //////////////WWWWWWWWWWWWWWWWW///////////////#
# ///////////////////////////////////////////// #
# ///////////////////////////////////////////// #
# /////////////////////////////////////////////B#
#################################################
