                                             
        /  |\/| |\ |\/ |\/|  |  /|\ 
        -- |  | |/ |   |  | `|   |  
         / |  | |\ |/\ |  |  |`  |

#############################################
#TS        9         W               W   E  #
#WWWWWWWWWWWWWWWWW   W               W  1WWW#
                 W   W               W  1W  
                 W1WWW               WWW1W
                 W1W                   W1W
             WWWWW1W               WWWW 1W
             W     W               W     W
             W  9  WWWWWWWWWWWWWWWWW  9  W
             W                           W
             WWWWWWWWWWWWWWWWWWWWWWWWWWWWW B
