     _  _  _   _  _     _ _     
    (  (_ |_) |_)(_ |\|  |
    _) (_ | \ |  (_ | |  |

###############################
#T                1           #
#     W2WWWWWWWWWWWWWWWWWWWW  #
#     W W         1           #
#     W3W  WWWWWWWWWWWWWWWWWWW#
#     W W         1           #
#     W4WWWWWWWWWWWWWWWWWWWW  #
#     W W         1           #
#     W5W  WWWWWWWWWWWWWWWWWWW#
#     W W         1           #
#     W6WWWWWWWWWWWWWWWWWWWW  #
#     W W         1           #
#     W7W  WWWWWWWWWWWWWWWWWWW#
#     W W         1           #
#     W8WWWWWWWWWWWWWWWWWWWW  #
#     W W         1           #
#  1  W9W  WWWWWWWWWWWWWWWWWWW#
#      EW         1         SB#
###############################
