##############################################################

                       ###############
T                      W      E      W
                       W  1 1 1 1 1  W
                       W   1 1 1 1   W
                       W  1 1 1 1 1  W
                       W   1 1 1 1   W
                       W  1 1 1 1 1  W
                       W   1 1 1 1   W
                       WS     9      W                      B
                       ###############

##############################################################
