    _  _  _   _  _     _ _   
   (  (_ |_) |_)(_ |\|  |
   _) (_ | \ |  (_ | |  |
LEVEL 10 O x 99 SCORE: 999999
#############################
#T              1           #
#   W2WWWWWWWWWWWWWWWWWWWWW #
#   W W         1           #
#   W3W WWWWWWWWWWWWWWWWWWWW#
#   W W         1           #
#   W4WWWWWWWWWWWWWWWWWWWWW #
#   W W         1           #
#   W5W WWWWWWWWWWWWWWWWWWWW#
#   W W         1           #
#   W6WWWWWWWWWWWWWWWWWWWWW #
#   W W         1           #
#   W7W WWWWWWWWWWWWWWWWWWWW#
#   W W         1           #
#   W8WWWWWWWWWWWWWWWWWWWWW #
#   W W         1           #
# 1 W9W WWWWWWWWWWWWWWWWWWWW#
#    EW         1         SB#
#############################
