 _______ _______ ______ ______ _______ _______ _______ 
|     __|    ___|   __ \   __ \    ___|    |  |_     _|
|__     |    ___|      <    __/    ___|       | |   |  
🐍______|_______|___|__|___|  |_______|__|____| |___🐍 

#######################################################
#T                                                    #
#                                                     #
#                                                     #
#                                                     #
#                                                     #
#                                                     #
#                                                     #
#                                                     #
#                                                     #
#                                                     #
#                                                     #
#                                                     #
#                                                     #
#S                                                   B#
#######################################################
