                               
###############################
#T                           E#
#     1        1        1     #
#    1W1      1W1      1W1    #
#     1        1        1     #
#                             #
#     1        1        1     #
#    1W1      1W1      1W1    #
#     1        1        1     #
#                             #
#     1        1        1     #
#    1W1      1W1      1W1    #
#     1        1        1     #
#S                           B#
###############################
