 /\/\/\/\/\/\/\/\/\/\/\/\/

###########################
#T           S            #
#                         #
#                         #
#                         #
#                         #
#                         #
#                         #
#                         #
#                        B#
###########################
