 /\/\/\/\/\/\/\/\/\/\/\/\/\/

#############################
#T            S             #
#                           #
#                           #
#                           #
#                           #
#                           #
#                           #
#                           #
#                           #
#                          B#
#############################
