 _______ _______ ______ ______ _______ _______ _______ 
|     __|    ___|   __ \   __ \    ___|    |  |_     _|
|__     |    ___|      <    __/    ___|       | |   |  
🐍______|_______|___|__|___|  |_______|__|____| |___🐍 

#######################################################
#T                                                    #
# E         9            8              7             #
#                                                     #
#WWWWWWWWWWWWWWWWWWWWWWWWWWWWWWWWWWWWWWWWWWWWWWWWWW 6 #
#                                                     #
#                        5                            #
#                                                     #
# 4 WWWWWWWWWWWWWWWWWWWWWWWWWWWWWWWWWWWWWWWWWWWWWWWWWW#
#                                                     #
#                        3                            #
#                                                     #
#WWWWWWWWWWWWWWWWWWWWWWWWWWWWWWWWWWWWWWWWWWWWWWWWWW 2 #
#                                                     #
# S                      1                            #
#                                                    B#
#######################################################
