 _______ _______ ______ ______ _______ _______ _______ 
|     __|    ___|   __ \   __ \    ___|    |  |_     _|
|__     |    ___|      <    __/    ___|       | |   |  
🐍______|_______|___|__|___|  |_______|__|____| |___🐍 

#######################################################
#T          1                                         #
# E                      2                            #
#                                       3             #
#WWWWWWWWWWWWWWWWWWWWWWWWWWWWWWWWWWWWWWWWWWWWWWWWWW 4 #
#                                                     #
#                        5                            #
#                                                     #
# 6 WWWWWWWWWWWWWWWWWWWWWWWWWWWWWWWWWWWWWWWWWWWWWWWWWW#
#                                                     #
#                                                     #
#                        7                            #
#WWWWWWWWWWWWWWWWWWWWWWWWWWWWWWWWWWWWWWWWWWWWWWWWWW 8 #
#                        9                            #
# S                                                   #
#                                                    B#
#######################################################
